+-------------------------------------------------------------+
|                                                             |
|                                                             |
|  C     C                                                    |
|                                                             |
|              C                                              |
|                                                             |
|       LR                                                    |
|       lr   LR                                               |
|  S    lr   lr                                               |
|BBBBBBBBBBBBBBBBBBBBBBBBBBBBBBBBBBBBBBBBBBBBBBBBBBBBBBBBBBBBB|
+-------------------------------------------------------------+